*******
*----A*
*-----*
*-----*
*--O--*
*-----*
*******
.