*******
*-----*
*-----*
<-----*
*-----*
*-----*
***v***
.