***^***
*-----*
*-----*
*----->
*-----*
*-----*
*******
.