***^***
*-----*
*-----*
<-----*
*-----*
*-----*
*******
.